+--------------------+
|. = ................|
|. =  ...............|
|. = ................|
|. =  ...............|
|....................|
|...      ...........|
|....................|
|....^^^^^^^^^^^.....|
|....................|
|......         .....|
|....................|
|....................|
|....................|
|..........  =  .....|
|..........  =  .....|
|..........  =  .....|
|....................|
+--------------------+