+--------------------+
|.~=~................|
|.~=~~...............|
|.~=~................|
|.~=~~...............|
|....................|
|...~~~~~~...........|
|....................|
|....^^^^^^^^^^^.....|
|....................|
|......~~~~~~~~~.....|
|....................|
|....................|
|....................|
|.......... ~=~~.....|
|.......... ~=~~.....|
|.......... ~=~~.....|
|....................|
+--------------------+
